"Date and time",Description,MCC,"Card currency amount, (UAH)","Operation amount","Operation currency","Exchange rate","Commission, (UAH)","Cashback amount, (UAH)",Balance
"02.11.2021 10:41:21","****0544",4829,-720.0,-720.0,UAH,—,—,—,2184.31
"02.11.2021 09:57:44",EVA,5977,-95.69,-95.69,UAH,—,—,—,2904.31
"02.11.2021 09:51:55","З Білої картки",4829,2800.0,2800.0,UAH,—,—,—,3000.0
"01.11.2021 19:56:12","Комуналка",4814,-173.71,-173.71,UAH,—,—,—,200.0
"01.11.2021 16:11:38","Сімейна Пекарня",5462,-68.0,-68.0,UAH,—,—,1.36,373.71
"01.11.2021 11:50:26","****7134",4829, 41.71,41.71,UAH,—,—,—,441.71